行動を代わる	に	人間に
記述をする	と	主体と
注目を集める	が	「サポートベクターマシン」が
学習を行う	に	元に
学習をする	て に は を を通して	なされている 元に ACT-Rでは 推論ルールを 生成規則を通して
進化を見せる	て て において は	加えて 活躍している 生成技術において （敵対的生成ネットワーク）は
開発を行う	は	エイダ・ラブレスは
処理を行う	て に に に により	付加して Webに コンピュータに 同年に ティム・バーナーズ＝リーにより
意味をする	に	データに
研究を進める	て	費やして
命令をする	で	機構で
運転をする	に	元に
特許をする	が に	日本が 2018年までに
運転をする	て に	基づいて 柔軟に
注目を集める	から は	ことから ファジィは
制御を用いる	て も	受けて 他社も
制御をする	から	少なさから
改善を果たす	が で に	チームが 画像処理コンテストで 2012年に
研究を続ける	が て	ジェフ・ホーキンスが 向けて
)をする	は	8月には
注目を集める	に	急速に
投資を行う	で に	民間企業主導で 全世界的に
探索を行う	で	無報酬で
推論を経る	を	段階を
研究を始める	とも は	マックスプランク研究所とも Googleは
研究を行う	て て	始めており 行っている
開発をする	で で は	官民一体で 日本で 中国では
投資をする	に は	2022年までに 韓国は
反乱を起こす	て に対して	於いて 人間に対して
監視を行う	に まで	人工知能に 歩行者まで
手続きを経る	を	ウイグル族を
制御をする	は	AIプログラムは
判断を介す	から	観点から
禁止を求める	が は	ヒューマン・ライツ・ウォッチが 4月には
競争を行う	は をめぐって	米国・中国・ロシアは 軍事利用をめぐって
追及を受ける	て で と とともに は	暴露されており 整合性で 拒否すると 「」とともに 公聴会では
研究をする	が	Microsoftが
解任をする	て は	含まれており Google社員らは
解散をする	が で は	倫理委員会が 理由で Googleは
存在を見いだす	に	ものに
話をする	は	哲学者は
議論を行う	まで	「これまで
